1111111111
1000000E01
1000C00001
10P0000001
1111111111